伊右衛門	いえもん	personal name (comes from the right guardhouse of the gates of the imperial palace)
猪右衛門	いえもん	personal name (comes from the right guardhouse of the gates of the imperial palace)
骨皮筋右衛門	ほねかわすじえもん	reduced to skin and bones
風邪	かぜ	cold (illness)
香具師	やし	charlatan, faker, huckster
七五三縄	しめなわ	(Shinto) rope used to cordon off consecrated areas or as a talisman against evil
百舌鳥	もず	shrike, bull-headed shrike
秋刀魚	さんま	pike (fish), Pacific saury

不忍池	しのばず(の)いけ	Shinobazu (place name in Ueno) - should be 忍不, but the order is reversed (Kanbun style)
尼崎駅	あま(が)さきえき	Amagasaki station in Amagasaki, Hyōgo
市谷	いち(が)や	Ichigaya, an area in the eastern portion of Shinjuku, Tōkyō
千利休	せん(の)りきゅう	Sen-no-Rikyū (historical figure)
一宮	いち(の)みや	place name (lit. first shrine)
二宮	に(の)みや	surname, place name (lit. second shrine)
井上	い(の)うえ	surname (lit. above the well)
合歓木	ねむ(の)き	silk tree
山手線	やま(の)てせん	Yamanote train line in Tōkyō
住道駅	すみ(の)どうえき	Suminodō station in Daito, Osaka
淡輪駅	たん(の)わえき	Tannowa station in Misaki, Osaka
甲浦駅	かん(の)うらえき	Kannoura station in Tōyō, Aki district, Kōchi
富海駅	と(の)みえき	Tonomi station in Hōfu, Yamaguchi
国府台駅	こう(の)だいえき	Kōnodai station in Ichikawa, Chiba
大楽毛駅	おた(の)しけえき	Otanoshike station in Kushiro, Hokkaidō
南風崎駅	はえ(の)さきえき	Haenosaki station in Haenosaki-chō, Sasebo City, Nagasaki
雑餉隈駅	ざっしょ(の)くまえき	Zasshonokuma station in Hakata-ku, Fukuoka
天叢雲剣	あま(の)むらくも(の)つるぎ	Ama-no-Murakumo no Tsurugi; the sword of the Imperial regalia, heavenly gathering of clouds sword
草薙剣	くさなぎ(の)つるぎ	Kusanagi-no-Tsurugi (alternate name for Ama-no-Murakumo no Tsurugi; the sword of the Imperial regalia), grass-mowing sword
竹内流	たけ(の)うちりゅう	Takenouchi-ryū; one of the oldest jujutsu koryū in Japan
八幡神	やはた(の)かみ	Hachiman (god of war), also known as Yahata-no-kami
伊邪那美命	いざなみ(の)みこと	Izanami-no-Mikoto; female deity who birthed Japan and the sun, moon, and storm gods

乗組員	のりくみいん	crew
受付	うけつけ	reception (desk);information desk;receipt;acceptance
日付	ひづけ	date;dating
番付	ばんづけ	ranking of entertainers, sumo wrestlers, etc.
割合	わりあい	rate;ratio;percentage;proportion
割引	わりびき	discount;reduction;rebate;(after a number) tenths discounted;tenths reduced
割高	わりだか	comparatively high;fairly expensive
役割	やくわり	part;assigning (allotment of) parts;role;duties
取引	とりひき	transactions;dealings;business
取扱注意	とりあつかいちゅうい	handling warning
取締役	とりしまりやく	company director;board member
取締役会	とりしまりやくかい	board of directors
頭取	とうどり	(bank) president
受身	うけみ	the defensive;passive attitude;passivity;passiveness;(linguistics) the passive;passive voice;(martial arts term) ukemi (the art of falling safely)
卸売	おろしうり	wholesale
卸売市場	おろしうりしじょう	wholesale market
卸売物価	おろしうりぶっか	wholesale price
売上高	うりあげだか	sales;amount sold;proceeds
小売店	こうりてん	retail store;retail shop
読売	よみうり	Yomiuri (newspaper)
公欠届	こうけつとどけ	absence permission slip
変更届	へんこうとどけ	notification of change;alteration report;registration of modification
竜巻	たつまき	tornado;waterspout
待合室	まちあいしつ	waiting room
時折	ときおり	sometimes
申込書	もうしこみしょ	application form;written application
立場	たちば	standpoint;position;situation
労働組合	ろうどうくみあい	labor union;labour union
組合	くみあい	association;union
中越	ちゅうごし	over center field (centre)
請負	うけおい	contract (for work);contracting;undertaking
掛軸	かけじく	hanging scroll
夕立	ゆうだち	(sudden) evening shower (rain)
空地	あきち	vacant land
雇主	やといぬし	employer
指図	さしず	instruction;mandate;directions
消印	けしいん	postmark;(postal) cancellation mark
終値	おわりね	closing price (stock exchange, etc.)
置物	おきもの	ornament;figurehead;object placed in tokonoma
物置	ものおき	storage room;storeroom;lumber room
仲買	なかがい	brokerage
縫目	ぬいめ	seam;stitch;suture
履物	はきもの	footwear;clogs
関取	せきとり	(sumo) ranking wrestler in the makuuchi (senior-grade) or juryo (junior-grade) divisions
取次	とりつぎ	agency;commission;distributor;intermediation
取締法	とりしまりほう	control law
受取人	うけとりにん	recipient
受付中	うけつけちゅう	currently accepting (applications, etc.)
差出人	さしだしにん	sender
貸出用	かしだしよう	circulation or lending (e.g. library books)
借入金	かりいれきん	loan;loan payable;debt
小売価格	こうりかかく	retail price
売上金	うりあげきん	proceeds
歌合	うたあわせ	poetry contest
貸付	かしつけ	loan
割引債	わりびきさい	discount bond
字引	じびき	dictionary
手引書	てびきしょ	handbook;manual;guide;primer
成金	なりきん	(derogatory) upstart;nouveau riche;new rich;coming into wealth suddenly
積立金	つみたてきん	deposit
書留	かきとめ	(abbreviation) registered mail
待合	まちあい	meeting place;assignation place
振替	ふりかえ	transfer (money);change
立入禁止	たちいりきんし	No Entry;No Trespassing;No Admittance;Off Limits;Keep Out;Keep Off
貸家	かしや	house for rent
貸間	かしま	room to let;room for rent
貸金	かしきん	loan
長者番付	ちょうじゃばんづけ	list of the richest people;list of the very highest income earners;billionaire's list
役割分担	やくわりぶんたん	division (distribution) of roles;role-sharing
役割演技	やくわりえんぎ	role-playing
四季折々	しきおりおり	from season to season;season by season;of each season;in each season
振替休日	ふりかえきゅうじつ	compensatory holiday;observed holiday (weekday holiday when the actual day is on a weekend);substitute holiday
養子縁組	ようしえんぐみ	adoption (of an heir)